abschrecken_	abschrecken
Blech_	Blech
Eiweiß_	Eiweiß
Form_	Form
Gemüse_	Gemüse
Gericht_	Gericht
Glas_	Glas
Hamburger_	Hamburger
Mandel_	Mandel
Messer_	Messer
Paprika_	Paprika
Prise_	Prise
Rum_	Rum
Salz_	Salz
schlagen_	schlagen
Schnee_	Schnee
Schnittlauch_	Schnittlauch
Schokolade_	Schokolade
Schuß_	Schuß
Strudel_	Strudel
trennen_	trennen
