abschrecken	abschrecken
Blech	Blech
Eiweiß	Eiweiß
Form	Form
Gemüse	Gemüse
Gericht	Gericht
Glas	Glas
Hamburger	Hamburger
Mandel	Mandel
Messer	Messer
Paprika	Paprika
Prise	Prise
Rum	Rum
Salz	Salz
schlagen	schlagen
Schnee	Schnee
Schnittlauch	Schnittlauch
Schokolade	Schokolade
Schuß	Schuß
Strudel	Strudel
trennen	trennen
